[
    [1,1,1,1,1,1,1,1,1,1,1,1,1,1,1,1,1,1,1,1,1,1,1,1,1,1,1,1],
    [1,1,0,0,0,0,0,0,1,1,0,0,0,0,0,0,0,1,0,0,0,0,0,0,0,0,0,1],
    [1,1,0,1,1,1,1,0,0,0,1,1,0,1,1,1,1,1,0,1,1,1,1,1,1,1,0,1],
    [1,0,0,0,0,0,0,0,1,0,0,0,0,0,0,0,0,0,0,0,0,1,4,0,0,1,0,1],
    [1,0,1,1,1,0,1,1,1,0,1,1,1,0,1,0,1,1,4,1,1,1,1,1,0,1,0,1],
    [1,0,0,0,1,1,1,0,1,0,1,1,1,0,1,0,1,1,0,1,0,0,0,1,0,1,0,1],
    [1,0,1,0,0,0,0,0,1,0,0,0,0,0,1,0,0,0,5,1,0,1,0,1,0,1,0,1],
    [1,0,1,1,1,0,1,0,1,0,1,1,1,1,1,0,1,1,0,1,0,1,0,1,0,1,0,1],
    [1,0,1,0,1,0,1,0,1,1,1,1,0,0,1,0,1,1,0,0,0,1,1,1,0,1,0,1],
    [1,0,1,0,1,0,1,0,1,0,0,0,0,1,1,0,1,1,0,1,1,1,0,0,0,1,0,1],
    [1,0,0,0,1,0,1,0,1,1,1,1,0,1,1,0,1,1,0,0,0,0,0,1,0,1,0,1],
    [1,0,1,1,1,0,1,0,1,0,1,1,0,1,1,0,1,1,4,1,1,0,1,1,0,1,0,1],
    [1,0,1,1,1,0,1,0,1,0,1,0,0,0,0,0,1,1,0,1,1,0,1,1,0,0,0,1],
    [1,0,1,0,1,1,1,0,1,0,1,1,1,0,1,4,1,1,0,1,0,0,0,1,0,1,0,1],
    [1,1,1,0,1,0,0,0,1,0,0,0,0,0,1,0,1,1,0,1,0,1,0,1,0,1,0,1],
    [1,0,0,0,1,1,0,1,1,0,1,1,1,0,1,1,1,1,0,1,0,1,0,1,0,1,0,1],
    [1,1,1,1,1,0,0,0,0,0,0,0,1,0,1,0,0,1,1,1,0,1,0,1,0,1,0,1],
    [1,0,0,0,1,1,0,1,1,0,1,1,1,0,1,1,0,1,0,1,1,1,0,1,0,1,0,1],
    [1,0,1,0,1,1,0,1,1,0,1,0,0,0,1,0,0,1,0,1,0,0,0,1,0,1,1,1],
    [1,0,1,7,1,1,0,1,1,0,1,0,1,0,1,0,1,1,0,1,0,1,0,0,0,0,1,1],
    [1,0,1,1,1,1,0,1,1,0,1,0,1,0,1,0,1,1,0,1,0,1,0,1,1,0,1,1],
    [1,0,0,0,1,0,0,0,0,0,1,0,1,0,0,0,0,0,0,1,0,1,0,1,1,0,1,1],
    [1,0,1,0,1,1,1,1,1,1,1,0,1,1,1,0,1,1,1,1,0,1,1,1,1,0,0,1],
    [1,4,1,0,0,0,0,0,0,1,1,0,1,0,0,0,1,0,0,0,0,1,1,1,1,1,1,1],
    [1,0,1,1,1,0,1,1,0,1,1,0,1,1,1,1,1,0,1,1,1,1,1,1,1,1,0,1],
    [1,9,0,0,0,4,1,1,0,0,0,0,0,0,0,1,1,0,0,0,0,0,0,0,0,0,0,1],
    [1,1,1,1,1,1,1,1,1,1,1,1,1,1,1,1,1,1,1,1,1,1,1,1,1,1,1,1]
]